1 2 3 3 x x x x 1 1 1 1 x x 2 2 
x x x x x x x x x x x x x x x x
1 1 2 2 3 3 0 0 3 3 2 2 1 1 0 0
1 2 3 3 x x x x 1 1 1 1 x x 2 2 
x x x x x x x x x x x x x x x x
1 1 2 2 3 3 0 0 3 3 2 2 1 1 0 0
1 2 3 3 x x x x 1 1 1 1 x x 2 2 
1 2 3 3 x x x x 1 1 1 1 x x 2 2
