x,x x,x x,x x,x x,x x,x x,x x,x x,x x,x
x,x x,x x,x x,x x,x x,x x,x x,x x,x x,x
x,x 0,0 0,0 0,0 0,0 0,0 x,x x,x x,x x,x
x,x x,x x,x x,x x,x x,x 0,1 x,x x,x x,x
x,x x,x x,x 0,0 0,0 0,0 x,x x,x x,x x,x
x,x 0,0 0,2 x,x x,x x,x x,x x,x x,x x,x
x,x 0,3 0,2 x,x x,x x,x x,x x,x x,x x,x
x,x x,x x,x x,x x,x x,x x,x x,x x,x x,x
x,x x,x x,x x,x x,x x,x x,x x,x x,x x,x 